1111111111111111111111111111111111111
1P04200202000000022000a20220220202221
1010101012101210101010101012121212121
1562200222022222002002222002002022201
1010121010121010101212101010121212101
1022000002200022020200222022202002221
1212101012101210101210101012101212121
120c0002002000002220022022200220i0201
1010101210101012121012101210101010121
120020022222220f002222002022020002221
1210121012101010101010101012121010121
1020022022020200022020022222202020201
10101010101212121012121012121a1012101
1000002e20022200000220202200220222021
1012101210101010121012101012121210101
1002022222202200200220220222222220021
1111111111111111111111111111111111111
