11111111111111111111111111111
1P0202000022002602000e02400a1
10121610101410101010101010121
122520220202202220220b0022001
1i1210101010121f1210101212121
102000h22c0020525202200200g01
11111111111111111111111111111
