11111111111111111111111111111
1P020002222002200020020220e01
10101212101412121010101210101
12202i00200020020202202222001
10101212101210101012101010101
1000220f022202202h20022240201
12101012101012101010101212121
12020020002200202202002c02001
10101010101012101012121210101
1020020202002002202g002002201
10101212121210151010121015121
1f022a0202020200d220200020001
121010121210101010121010121h1
16202022000220202002002200201
12101210121012101010101010121
12002200200c20226200200202041
10101010161210101212121012101
1220020200020020200e002220021
10121010101010101212121010101
10b20020252020020000220026001
11111111111111111111111111111
