11111111111111111111111111111
1P020002222000000000000000001
10101212101212121010101010101
12202b00200000020000000000001
10101212101210101010101010101
10000000022200002000000000001
12101012101010101010101010101
12020000002200002000000000001
10101010101010101010101010101
10200200000020000000000000001
10101212121010101010101010101
10022a02020000000000000000001
12101012121010101010101010101
12202022000000002000000000001
12101210101010101010101010101
10000000000000000000000000001
10101010101010101010101010101
10000000000000000000000000001
10101010101010101010101010101
100000000000000000000000000a1
11111111111111111111111111111
