11111111111111111111111111111
1P20000000000a000000000000001
10101010101010101010101010101
100000000e0000000000000000001
10101010101010101010101010101
100000000000b0000000000000001
11111111111111111111111111111
